Area_Name,Year,Rape_Cases_Reported,Victims_Above_50_Yrs,Victims_Between_10-14_Yrs,Victims_Between_14-18_Yrs,Victims_Between_18-30_Yrs,Victims_Between_30-50_Yrs,Victims_Upto_10_Yrs,total rapes
Andaman & Nicobar Islands,2001,3,0,0,3,0,0,0,6
Andaman & Nicobar Islands,2002,2,0,0,1,1,0,0,4
Andaman & Nicobar Islands,2003,2,0,0,1,0,0,1,4
Andaman & Nicobar Islands,2004,10,0,1,7,1,1,0,20
Andaman & Nicobar Islands,2005,4,0,0,2,2,0,0,8
Andaman & Nicobar Islands,2006,6,0,2,1,1,0,2,12
Andaman & Nicobar Islands,2007,3,0,0,3,0,0,0,6
Andaman & Nicobar Islands,2008,12,0,1,7,3,1,0,24
Andaman & Nicobar Islands,2009,18,0,3,7,5,1,2,36
Andaman & Nicobar Islands,2010,24,0,1,12,8,1,2,48
Andaman & Nicobar Islands,2011,19,0,1,9,5,1,1,36
Andaman & Nicobar Islands,2012,21,0,2,9,6,1,1,40
Andaman & Nicobar Islands,2013,23,0,2,10,7,1,2,45
Andaman & Nicobar Islands,2014,25,0,2,11,7,1,2,48
Andaman & Nicobar Islands,2015,27,0,2,12,8,1,2,52
Andaman & Nicobar Islands,2016,29,0,2,13,9,1,2,56
Andaman & Nicobar Islands,2017,31,0,3,14,9,1,2,60
Andaman & Nicobar Islands,2018,33,0,3,15,10,1,2,64
Andaman & Nicobar Islands,2019,35,0,3,15,11,1,3,68
Andaman & Nicobar Islands,2020,37,0,3,16,11,1,3,71
Andaman & Nicobar Islands,2021,39,0,3,17,12,2,3,76
Andaman & Nicobar Islands,2022,41,0,4,18,13,2,3,81
Andaman & Nicobar Islands,2023,43,0,4,19,13,2,3,84
Andaman & Nicobar Islands,2024,45,0,4,20,14,2,3,88
Andhra Pradesh,2001,871,14,138,254,328,80,57,1742
Andhra Pradesh,2002,1002,8,67,35,709,148,35,2004
Andhra Pradesh,2003,946,7,135,215,429,127,33,1892
Andhra Pradesh,2004,1016,7,145,163,516,130,55,2032
Andhra Pradesh,2005,935,6,106,177,490,124,32,1870
Andhra Pradesh,2006,1049,10,128,238,536,91,46,2098
Andhra Pradesh,2007,1070,7,110,201,572,128,52,2140
Andhra Pradesh,2008,1257,11,126,237,660,174,49,2514
Andhra Pradesh,2009,1188,14,167,208,642,116,41,2376
Andhra Pradesh,2010,1362,15,133,283,749,152,30,2724
Andhra Pradesh,2011,1321,12,143,259,719,147,39,2640
Andhra Pradesh,2012,1367,12,146,270,747,151,38,2731
Andhra Pradesh,2013,1412,13,149,280,776,155,37,2822
Andhra Pradesh,2014,1458,13,152,291,804,158,37,2913
Andhra Pradesh,2015,1504,14,155,302,833,162,36,3006
Andhra Pradesh,2016,1550,14,159,312,861,166,35,3097
Andhra Pradesh,2017,1595,15,162,323,889,170,34,3188
Andhra Pradesh,2018,1641,15,165,334,918,173,34,3280
Andhra Pradesh,2019,1687,16,168,344,946,177,33,3371
Andhra Pradesh,2020,1733,16,171,355,975,181,32,3463
Andhra Pradesh,2021,1779,16,175,366,1003,185,32,3556
Andhra Pradesh,2022,1824,17,178,376,1032,189,31,3647
Andhra Pradesh,2023,1870,17,181,387,1060,192,30,3737
Andhra Pradesh,2024,1916,18,184,398,1088,196,29,3829
Arunachal Pradesh,2001,33,0,0,1,28,4,0,66
Arunachal Pradesh,2002,38,0,0,3,30,5,0,76
Arunachal Pradesh,2003,31,0,5,4,19,0,3,62
Arunachal Pradesh,2004,42,0,9,0,31,0,2,84
Arunachal Pradesh,2005,35,0,5,2,25,0,3,70
Arunachal Pradesh,2006,37,0,0,0,34,3,0,74
Arunachal Pradesh,2007,48,0,0,0,42,5,1,96
Arunachal Pradesh,2008,42,0,7,0,31,0,4,84
Arunachal Pradesh,2009,59,0,12,0,42,1,4,118
Arunachal Pradesh,2010,47,0,10,0,34,1,2,94
Arunachal Pradesh,2011,52,0,9,0,39,0,3,103
Arunachal Pradesh,2012,54,0,10,-1,41,0,3,107
Arunachal Pradesh,2013,57,0,11,-1,42,0,3,112
Arunachal Pradesh,2014,59,0,12,-1,43,0,4,117
Arunachal Pradesh,2015,61,0,13,-1,45,0,4,122
Arunachal Pradesh,2016,63,0,14,-2,46,0,4,125
Arunachal Pradesh,2017,65,0,15,-2,48,0,5,131
Arunachal Pradesh,2018,67,0,16,-2,49,0,5,135
Arunachal Pradesh,2019,69,0,17,-3,51,-1,5,138
Arunachal Pradesh,2020,71,0,18,-3,52,-1,5,142
Arunachal Pradesh,2021,73,0,19,-3,54,-1,6,148
Arunachal Pradesh,2022,76,0,20,-4,55,-1,6,152
Arunachal Pradesh,2023,78,0,20,-4,57,-2,6,155
Arunachal Pradesh,2024,80,0,21,-4,58,-2,6,159
Assam,2001,817,2,73,245,370,119,8,1634
Assam,2002,970,0,0,3,621,346,0,1940
Assam,2003,1095,3,5,0,827,260,0,2190
Assam,2004,1171,14,0,0,857,293,7,2342
Assam,2005,1238,15,34,37,847,286,19,2476
Assam,2006,1244,2,21,32,892,289,8,2488
Assam,2007,1437,14,0,40,898,485,0,2874
Assam,2008,1438,21,5,20,849,541,2,2876
Assam,2009,1631,14,6,3,1230,377,1,3262
Assam,2010,1721,10,9,29,1116,556,1,3442
Assam,2011,1785,17,-2,-16,1225,559,2,3570
Assam,2012,1878,19,-6,-27,1294,596,1,3755
Assam,2013,1970,20,-9,-37,1362,634,1,3941
Assam,2014,2063,22,-12,-48,1430,671,0,4126
Assam,2015,2156,23,-16,-58,1498,708,0,4311
Assam,2016,2248,25,-19,-69,1566,745,0,4496
Assam,2017,2341,26,-22,-79,1635,782,0,4683
Assam,2018,2433,28,-26,-90,1703,819,-1,4866
Assam,2019,2526,29,-29,-100,1771,857,-1,5053
Assam,2020,2619,31,-32,-111,1839,894,-2,5238
Assam,2021,2711,32,-36,-121,1907,931,-2,5422
Assam,2022,2804,34,-39,-131,1976,968,-3,5609
Assam,2023,2897,35,-42,-142,2044,1005,-3,5794
Assam,2024,2989,37,-46,-152,2112,1042,-4,5978
Bihar,2001,888,0,15,198,562,112,1,1776
Bihar,2002,1040,0,2,2,805,231,0,2080
Bihar,2003,985,0,1,1,686,296,1,1970
Bihar,2004,1390,6,3,0,1018,363,0,2780
Bihar,2005,1147,0,6,2,872,267,0,2294
Bihar,2006,1232,9,0,17,956,250,0,2464
Bihar,2007,1555,0,28,79,1186,253,9,3110
Bihar,2008,1302,24,11,80,1028,159,0,2604
Bihar,2009,929,0,19,32,765,101,12,1858
Bihar,2010,795,0,17,89,616,65,8,1590
Bihar,2011,1144,7,18,45,932,130,8,2284
Bihar,2012,1148,8,20,45,948,116,9,2294
Bihar,2013,1151,8,21,44,963,102,10,2299
Bihar,2014,1154,9,23,43,978,87,11,2305
Bihar,2015,1158,10,24,42,993,73,12,2312
Bihar,2016,1161,10,26,42,1008,59,13,2319
Bihar,2017,1164,11,28,41,1023,44,14,2325
Bihar,2018,1168,12,29,40,1039,30,15,2333
Bihar,2019,1171,12,31,39,1054,16,16,2339
Bihar,2020,1174,13,32,39,1069,1,17,2345
Bihar,2021,1178,14,34,38,1084,-12,18,2354
Bihar,2022,1181,15,35,37,1099,-26,20,2361
Bihar,2023,1184,15,37,36,1114,-41,21,2366
Bihar,2024,1188,16,38,36,1130,-55,22,2375
Chandigarh,2001,18,0,8,4,4,3,0,37
Chandigarh,2002,18,0,4,1,9,3,1,36
Chandigarh,2003,18,0,1,5,7,2,3,36
Chandigarh,2004,19,0,5,3,5,1,5,38
Chandigarh,2005,33,0,4,10,5,7,7,66
Chandigarh,2006,19,0,2,6,4,4,3,38
Chandigarh,2007,22,0,3,2,11,3,3,44
Chandigarh,2008,20,0,3,7,7,1,2,40
Chandigarh,2009,29,0,8,10,8,0,3,58
Chandigarh,2010,31,0,8,4,15,0,4,62
Chandigarh,2011,29,0,5,7,11,0,4,56
Chandigarh,2012,30,0,5,7,11,0,4,57
Chandigarh,2013,31,0,5,8,12,0,4,60
Chandigarh,2014,32,0,6,8,13,0,4,63
Chandigarh,2015,34,0,6,9,13,0,5,67
Chandigarh,2016,35,0,6,9,14,0,5,69
Chandigarh,2017,36,0,6,9,15,-1,5,70
Chandigarh,2018,37,0,6,10,15,-1,5,72
Chandigarh,2019,38,0,7,10,16,-1,5,75
Chandigarh,2020,40,0,7,11,17,-1,6,80
Chandigarh,2021,41,0,7,11,17,-2,6,80
Chandigarh,2022,42,0,7,11,18,-2,6,82
Chandigarh,2023,43,0,7,12,19,-2,6,85
Chandigarh,2024,45,0,7,12,19,-3,7,87
Chhattisgarh,2001,959,4,191,218,384,137,25,1918
Chhattisgarh,2002,992,11,131,25,652,147,26,1984
Chhattisgarh,2003,898,5,97,62,376,331,27,1796
Chhattisgarh,2004,969,9,61,233,426,226,14,1938
Chhattisgarh,2005,990,16,112,255,392,200,15,1980
Chhattisgarh,2006,995,27,104,316,337,183,28,1990
Chhattisgarh,2007,982,13,117,219,500,101,32,1964
Chhattisgarh,2008,978,3,80,307,388,176,24,1956
Chhattisgarh,2009,976,9,227,87,460,113,80,1952
Chhattisgarh,2010,1012,16,87,271,424,190,24,2024
Chhattisgarh,2011,1002,14,114,271,408,149,43,2001
Chhattisgarh,2012,1006,15,113,284,404,143,46,2011
Chhattisgarh,2013,1011,16,112,297,399,138,48,2021
Chhattisgarh,2014,1016,16,110,310,394,132,51,2029
Chhattisgarh,2015,1021,17,109,323,390,126,53,2039
Chhattisgarh,2016,1026,18,108,336,385,121,56,2050
Chhattisgarh,2017,1031,18,107,349,381,115,58,2059
Chhattisgarh,2018,1036,19,106,362,376,110,61,2070
Chhattisgarh,2019,1041,20,105,375,371,104,63,2079
Chhattisgarh,2020,1046,20,104,388,367,98,66,2089
Chhattisgarh,2021,1051,21,102,401,362,93,69,2099
Chhattisgarh,2022,1056,22,101,414,358,87,71,2109
Chhattisgarh,2023,1060,22,100,427,353,81,74,2117
Chhattisgarh,2024,1065,23,99,440,349,76,76,2128
Dadra & Nagar Haveli,2001,6,0,0,3,3,0,0,12
Dadra & Nagar Haveli,2002,4,0,1,1,1,0,1,8
Dadra & Nagar Haveli,2003,1,0,0,0,1,0,0,2
Dadra & Nagar Haveli,2004,7,0,0,0,6,1,0,14
Dadra & Nagar Haveli,2005,5,0,0,0,5,0,0,10
Dadra & Nagar Haveli,2006,6,0,1,2,1,0,2,12
Dadra & Nagar Haveli,2007,7,0,2,4,0,0,1,14
Dadra & Nagar Haveli,2008,6,0,1,2,3,0,0,12
Dadra & Nagar Haveli,2009,4,0,2,0,2,0,0,8
Dadra & Nagar Haveli,2010,3,0,1,1,0,0,1,6
Dadra & Nagar Haveli,2011,4,0,1,1,1,0,0,7
Dadra & Nagar Haveli,2012,4,0,1,1,0,0,0,6
Dadra & Nagar Haveli,2013,4,0,2,1,0,0,0,7
Dadra & Nagar Haveli,2014,4,0,2,1,0,0,0,7
Dadra & Nagar Haveli,2015,4,0,2,1,0,0,0,7
Dadra & Nagar Haveli,2016,4,0,2,1,0,0,0,7
Dadra & Nagar Haveli,2017,4,0,2,1,0,0,0,7
Dadra & Nagar Haveli,2018,4,0,2,1,0,0,1,8
Dadra & Nagar Haveli,2019,4,0,3,1,0,0,1,9
Dadra & Nagar Haveli,2020,4,0,3,1,0,0,1,9
Dadra & Nagar Haveli,2021,4,0,3,1,0,0,1,9
Dadra & Nagar Haveli,2022,4,0,3,1,-1,0,1,8
Dadra & Nagar Haveli,2023,4,0,3,1,-1,0,1,8
Dadra & Nagar Haveli,2024,4,0,3,1,-1,0,1,8
Daman & Diu,2001,0,0,0,0,0,0,0,0
Daman & Diu,2002,0,0,0,0,0,0,0,0
Daman & Diu,2003,5,0,0,3,0,0,2,10
Daman & Diu,2004,1,0,0,1,0,0,0,2
Daman & Diu,2005,2,0,1,0,0,1,0,4
Daman & Diu,2006,3,0,0,0,2,0,1,6
Daman & Diu,2007,1,0,0,0,1,0,0,2
Daman & Diu,2008,0,0,0,0,0,0,0,0
Daman & Diu,2009,1,0,0,0,0,0,1,2
Daman & Diu,2010,1,0,0,0,0,0,1,2
Daman & Diu,2011,1,0,0,0,0,0,0,1
Daman & Diu,2012,1,0,0,0,0,0,0,1
Daman & Diu,2013,1,0,0,0,0,0,0,1
Daman & Diu,2014,0,0,0,0,0,0,0,0
Daman & Diu,2015,0,0,0,0,0,0,0,0
Daman & Diu,2016,0,0,0,0,0,0,0,0
Daman & Diu,2017,0,0,0,0,0,0,0,0
Daman & Diu,2018,0,0,0,0,0,0,1,1
Daman & Diu,2019,0,0,0,-1,0,0,1,0
Daman & Diu,2020,0,0,0,-1,0,0,1,0
Daman & Diu,2021,0,0,0,-1,0,0,1,0
Daman & Diu,2022,0,0,0,-1,0,0,1,0
Daman & Diu,2023,0,0,0,-1,0,0,1,0
Daman & Diu,2024,0,0,0,-1,0,0,1,0
Delhi,2001,381,0,81,154,59,41,48,764
Delhi,2002,403,0,54,52,217,49,35,810
Delhi,2003,490,0,50,76,321,17,26,980
Delhi,2004,551,0,126,77,282,6,60,1102
Delhi,2005,658,2,120,55,404,25,60,1324
Delhi,2006,623,2,111,267,155,21,70,1249
Delhi,2007,598,1,94,228,179,24,76,1200
Delhi,2008,466,6,95,135,133,30,71,936
Delhi,2009,469,1,72,188,141,20,47,938
Delhi,2010,507,1,79,174,168,34,51,1014
Delhi,2011,567,2,95,210,170,21,67,1132
Delhi,2012,576,3,97,223,164,20,69,1152
Delhi,2013,586,3,98,235,158,19,72,1171
Delhi,2014,596,3,99,248,151,18,74,1189
Delhi,2015,605,4,101,261,145,18,77,1211
Delhi,2016,615,4,102,273,139,17,79,1229
Delhi,2017,624,4,104,286,132,16,81,1247
Delhi,2018,634,5,105,299,126,15,84,1268
Delhi,2019,644,5,106,311,120,14,86,1286
Delhi,2020,653,5,108,324,113,13,89,1305
Delhi,2021,663,5,109,337,107,12,91,1324
Delhi,2022,672,6,110,349,101,11,93,1342
Delhi,2023,682,6,112,362,94,10,96,1362
Delhi,2024,691,6,113,375,88,9,98,1380
Goa,2001,12,0,7,1,0,1,3,24
Goa,2002,12,0,3,3,4,1,1,24
Goa,2003,31,0,9,8,7,2,6,63
Goa,2004,37,0,7,5,12,5,8,74
Goa,2005,20,0,4,7,4,1,4,40
Goa,2006,21,1,4,9,5,1,1,42
Goa,2007,20,0,4,7,4,1,4,40
Goa,2008,30,2,6,11,7,3,1,60
Goa,2009,47,0,11,21,15,2,1,97
Goa,2010,36,2,5,14,11,0,4,72
Goa,2011,40,1,6,17,12,1,2,79
Goa,2012,42,1,6,19,12,1,2,83
Goa,2013,45,1,6,20,13,1,1,87
Goa,2014,47,1,6,22,14,1,1,92
Goa,2015,49,2,6,23,15,1,1,97
Goa,2016,52,2,6,25,16,1,1,103
Goa,2017,54,2,6,27,17,1,1,108
Goa,2018,57,2,7,28,18,1,0,113
Goa,2019,59,2,7,30,19,0,0,117
Goa,2020,62,3,7,31,20,0,0,123
Goa,2021,64,3,7,33,21,0,0,128
Goa,2022,67,3,7,35,22,0,0,134
Goa,2023,69,3,7,36,23,0,0,138
Goa,2024,72,3,7,38,24,0,0,144
Gujarat,2001,286,0,23,87,125,36,15,572
Gujarat,2002,267,0,16,43,176,17,16,535
Gujarat,2003,236,0,17,46,143,13,17,472
Gujarat,2004,339,2,27,57,194,47,12,678
Gujarat,2005,324,0,28,44,218,16,18,648
Gujarat,2006,354,1,30,62,213,28,20,708
Gujarat,2007,316,1,30,51,180,37,18,633
Gujarat,2008,374,1,27,57,217,57,15,748
Gujarat,2009,433,1,27,50,308,32,15,866
Gujarat,2010,408,2,28,53,261,42,22,816
Gujarat,2011,430,1,31,48,285,44,19,858
Gujarat,2012,448,1,32,47,300,46,19,893
Gujarat,2013,466,2,33,45,315,48,19,928
Gujarat,2014,483,2,34,44,330,51,20,964
Gujarat,2015,501,2,35,43,345,53,20,999
Gujarat,2016,518,2,36,42,360,55,21,1034
Gujarat,2017,536,2,38,40,375,57,21,1069
Gujarat,2018,554,2,39,39,390,59,21,1104
Gujarat,2019,571,3,40,38,405,62,22,1141
Gujarat,2020,589,3,41,37,420,64,22,1176
Gujarat,2021,607,3,42,36,435,66,23,1212
Gujarat,2022,624,3,43,34,450,68,23,1245
Gujarat,2023,642,3,44,33,465,70,23,1280
Gujarat,2024,660,3,45,32,480,72,24,1316
Haryana,2001,398,3,62,125,134,40,34,796
Haryana,2002,361,1,49,6,237,39,29,722
Haryana,2003,353,0,5,70,248,28,2,706
Haryana,2004,386,0,2,20,315,47,2,772
Haryana,2005,461,6,34,97,181,143,0,922
Haryana,2006,608,5,22,153,376,51,1,1216
Haryana,2007,488,3,26,79,322,41,17,976
Haryana,2008,631,5,22,38,495,61,10,1262
Haryana,2009,603,3,27,70,430,54,19,1206
Haryana,2010,720,5,23,80,481,127,4,1440
Haryana,2011,715,5,15,77,519,94,3,1428
Haryana,2012,754,5,13,78,555,100,1,1506
Haryana,2013,793,6,10,79,591,105,0,1584
Haryana,2014,832,6,8,79,627,111,-1,1662
Haryana,2015,871,6,6,80,663,117,-2,1741
Haryana,2016,910,7,4,81,698,123,-4,1819
Haryana,2017,949,7,2,81,734,128,-5,1896
Haryana,2018,988,8,0,82,770,134,-7,1975
Haryana,2019,1027,8,-2,83,806,140,-8,2054
Haryana,2020,1066,8,-4,83,842,145,-10,2130
Haryana,2021,1105,9,-6,84,878,151,-12,2209
Haryana,2022,1144,9,-8,85,914,157,-13,2288
Haryana,2023,1183,9,-10,86,950,163,-15,2366
Haryana,2024,1222,10,-13,86,986,168,-16,2443
Himachal Pradesh,2001,124,2,15,43,35,9,20,248
Himachal Pradesh,2002,137,4,5,16,71,36,5,274
Himachal Pradesh,2003,126,0,14,25,56,23,8,252
Himachal Pradesh,2004,153,5,11,17,68,48,4,306
Himachal Pradesh,2005,141,2,17,30,63,18,11,282
Himachal Pradesh,2006,113,1,9,27,66,4,6,226
Himachal Pradesh,2007,159,2,19,46,58,23,11,318
Himachal Pradesh,2008,157,1,16,44,68,20,8,314
Himachal Pradesh,2009,183,0,16,55,84,16,12,366
Himachal Pradesh,2010,160,1,16,48,67,20,8,320
Himachal Pradesh,2011,171,0,17,51,77,16,7,339
Himachal Pradesh,2012,176,0,18,54,79,15,7,349
Himachal Pradesh,2013,181,0,18,57,82,15,7,360
Himachal Pradesh,2014,186,0,19,60,84,14,7,370
Himachal Pradesh,2015,190,0,20,63,87,13,6,379
Himachal Pradesh,2016,195,0,20,66,89,12,6,388
Himachal Pradesh,2017,200,-1,21,69,92,11,6,398
Himachal Pradesh,2018,205,-1,22,72,94,10,6,408
Himachal Pradesh,2019,210,-1,22,75,97,9,5,417
Himachal Pradesh,2020,214,-1,23,78,99,8,5,426
Himachal Pradesh,2021,219,-2,24,81,102,8,5,437
Himachal Pradesh,2022,224,-2,24,84,104,7,4,445
Himachal Pradesh,2023,229,-2,25,87,107,6,4,456
Himachal Pradesh,2024,233,-2,26,90,109,5,4,465
Jammu & Kashmir,2001,169,0,24,41,84,20,0,338
Jammu & Kashmir,2002,192,1,0,7,140,44,0,384
Jammu & Kashmir,2003,211,0,1,0,147,62,1,422
Jammu & Kashmir,2004,218,0,0,2,170,44,2,436
Jammu & Kashmir,2005,201,2,0,3,153,42,1,402
Jammu & Kashmir,2006,250,1,8,0,193,48,0,500
Jammu & Kashmir,2007,288,0,5,10,176,97,0,576
Jammu & Kashmir,2008,219,0,0,3,155,59,2,438
Jammu & Kashmir,2009,237,2,1,3,177,52,0,472
Jammu & Kashmir,2010,245,0,1,7,187,50,0,490
Jammu & Kashmir,2011,266,0,-2,-2,201,67,0,530
Jammu & Kashmir,2012,274,0,-3,-4,208,70,0,545
Jammu & Kashmir,2013,282,0,-4,-5,216,73,0,562
Jammu & Kashmir,2014,289,0,-5,-7,224,76,0,577
Jammu & Kashmir,2015,297,0,-6,-9,232,79,0,593
Jammu & Kashmir,2016,305,0,-7,-11,239,82,0,608
Jammu & Kashmir,2017,313,1,-8,-13,247,84,0,624
Jammu & Kashmir,2018,321,1,-9,-14,255,87,0,641
Jammu & Kashmir,2019,329,1,-10,-16,263,90,0,657
Jammu & Kashmir,2020,337,1,-11,-18,271,93,0,673
Jammu & Kashmir,2021,344,1,-13,-20,278,96,0,686
Jammu & Kashmir,2022,352,1,-14,-22,286,99,0,702
Jammu & Kashmir,2023,360,1,-15,-24,294,102,0,718
Jammu & Kashmir,2024,368,1,-16,-25,302,105,0,735
Jharkhand,2001,567,0,3,4,478,73,9,1134
Jharkhand,2002,797,0,0,43,676,78,0,1594
Jharkhand,2003,712,0,6,10,606,90,0,1424
Jharkhand,2004,797,0,0,43,676,78,0,1594
Jharkhand,2005,753,1,7,12,384,343,6,1506
Jharkhand,2006,799,2,45,198,419,133,2,1598
Jharkhand,2007,855,5,15,8,639,188,0,1710
Jharkhand,2008,791,2,2,5,662,119,1,1582
Jharkhand,2009,719,0,0,5,494,216,4,1438
Jharkhand,2010,773,0,0,0,604,169,0,1546
Jharkhand,2011,820,1,9,24,565,218,0,1637
Jharkhand,2012,832,2,9,23,566,231,0,1663
Jharkhand,2013,843,2,9,21,566,243,0,1684
Jharkhand,2014,855,2,9,20,567,256,0,1709
Jharkhand,2015,867,2,9,18,567,269,0,1732
Jharkhand,2016,878,2,10,17,567,282,-1,1755
Jharkhand,2017,890,2,10,15,568,294,-1,1778
Jharkhand,2018,901,2,10,14,568,307,-1,1801
Jharkhand,2019,913,3,10,12,569,320,-2,1825
Jharkhand,2020,925,3,10,11,569,332,-2,1848
Jharkhand,2021,936,3,11,9,569,345,-2,1871
Jharkhand,2022,948,3,11,8,570,358,-2,1896
Jharkhand,2023,960,3,11,6,570,370,-3,1917
Jharkhand,2024,971,3,11,5,570,383,-3,1940
Karnataka,2001,293,0,63,62,123,21,24,586
Karnataka,2002,292,1,10,6,218,54,3,584
Karnataka,2003,321,16,47,67,135,38,18,642
Karnataka,2004,291,0,15,12,201,48,15,582
Karnataka,2005,343,0,13,21,234,61,14,686
Karnataka,2006,400,2,16,46,268,45,23,800
Karnataka,2007,436,7,32,32,297,48,20,872
Karnataka,2008,446,1,24,52,301,47,21,892
Karnataka,2009,509,4,49,18,361,38,39,1018
Karnataka,2010,586,3,47,69,369,88,10,1172
Karnataka,2011,567,3,33,43,396,66,24,1132
Karnataka,2012,599,3,34,44,422,69,25,1196
Karnataka,2013,631,3,34,45,449,72,26,1260
Karnataka,2014,663,3,35,46,475,75,27,1324
Karnataka,2015,695,3,35,47,502,78,28,1388
Karnataka,2016,727,3,35,48,528,81,29,1451
Karnataka,2017,759,3,36,49,555,85,30,1517
Karnataka,2018,791,3,36,50,581,88,31,1580
Karnataka,2019,823,3,37,51,608,91,32,1645
Karnataka,2020,855,3,37,52,634,94,33,1708
Karnataka,2021,887,3,37,53,660,97,34,1771
Karnataka,2022,918,3,38,54,687,100,35,1835
Karnataka,2023,950,2,38,55,713,103,36,1897
Karnataka,2024,982,2,39,56,740,107,37,1963
Kerala,2001,562,1,46,126,306,64,19,1124
Kerala,2002,499,3,29,132,265,45,25,998
Kerala,2003,394,2,36,13,267,56,20,788
Kerala,2004,480,6,36,104,258,57,19,960
Kerala,2005,478,8,31,86,236,90,30,959
Kerala,2006,601,7,59,127,281,96,35,1206
Kerala,2007,512,5,45,115,262,63,23,1025
Kerala,2008,568,6,51,139,274,73,27,1138
Kerala,2009,568,10,45,157,253,70,33,1136
Kerala,2010,634,12,48,133,328,86,29,1270
Kerala,2011,603,11,51,144,279,86,32,1206
Kerala,2012,617,12,52,150,281,88,33,1233
Kerala,2013,630,13,54,156,282,91,35,1261
Kerala,2014,643,14,55,161,283,94,36,1286
Kerala,2015,657,15,57,167,284,97,37,1314
Kerala,2016,670,16,59,173,286,100,38,1342
Kerala,2017,684,17,60,178,287,103,39,1368
Kerala,2018,697,18,62,184,288,106,41,1396
Kerala,2019,711,19,63,190,289,109,42,1423
Kerala,2020,724,20,65,195,291,112,43,1450
Kerala,2021,738,21,67,201,292,115,44,1478
Kerala,2022,751,22,68,207,293,118,45,1504
Kerala,2023,765,23,70,213,294,121,47,1533
Kerala,2024,778,24,71,218,296,124,48,1559
Lakshadweep,2001,0,0,0,0,0,0,0,0
Lakshadweep,2002,1,0,0,0,0,1,0,2
Lakshadweep,2003,2,0,0,0,2,0,0,4
Lakshadweep,2004,0,0,0,0,0,0,0,0
Lakshadweep,2005,0,0,0,0,0,0,0,0
Lakshadweep,2006,0,0,0,0,0,0,0,0
Lakshadweep,2007,1,0,0,0,1,0,0,2
Lakshadweep,2008,2,0,0,0,1,1,0,4
Lakshadweep,2009,1,0,0,0,1,0,0,2
Lakshadweep,2010,0,0,0,0,0,0,0,0
Lakshadweep,2011,0,0,0,0,0,0,0,0
Lakshadweep,2012,0,0,0,0,0,0,0,0
Lakshadweep,2013,0,0,0,0,0,0,0,0
Lakshadweep,2014,0,0,0,0,0,0,0,0
Lakshadweep,2015,0,0,0,0,0,0,0,0
Lakshadweep,2016,0,0,0,0,0,0,0,0
Lakshadweep,2017,0,0,0,0,0,0,0,0
Lakshadweep,2018,0,0,0,0,0,0,0,0
Lakshadweep,2019,0,0,0,0,0,0,0,0
Lakshadweep,2020,0,0,0,0,0,0,0,0
Lakshadweep,2021,0,0,0,0,0,0,0,0
Lakshadweep,2022,1,0,0,0,1,0,0,2
Lakshadweep,2023,1,0,0,0,1,0,0,2
Lakshadweep,2024,1,0,0,0,1,0,0,2
Madhya Pradesh,2001,2851,27,304,557,1250,627,86,5702
Madhya Pradesh,2002,2891,14,185,252,1549,811,80,5782
Madhya Pradesh,2003,2738,7,231,405,1546,486,63,5476
Madhya Pradesh,2004,2875,14,280,338,1673,478,92,5750
Madhya Pradesh,2005,2921,26,294,474,1396,629,102,5842
Madhya Pradesh,2006,2900,7,96,710,1402,662,23,5800
Madhya Pradesh,2007,3010,43,287,692,1399,525,64,6020
Madhya Pradesh,2008,2937,20,227,596,1548,477,69,5874
Madhya Pradesh,2009,2998,11,291,704,1405,511,76,5996
Madhya Pradesh,2010,3135,12,304,826,1364,577,53,6271
Madhya Pradesh,2011,3081,17,268,816,1426,497,55,6160
Madhya Pradesh,2012,3110,17,271,864,1422,482,52,6218
Madhya Pradesh,2013,3138,17,274,911,1417,468,49,6274
Madhya Pradesh,2014,3166,16,277,959,1412,453,47,6330
Madhya Pradesh,2015,3195,16,281,1006,1407,438,44,6387
Madhya Pradesh,2016,3223,16,284,1054,1403,424,41,6445
Madhya Pradesh,2017,3252,16,287,1101,1398,409,38,6501
Madhya Pradesh,2018,3280,16,291,1149,1393,394,36,6559
Madhya Pradesh,2019,3308,16,294,1196,1388,380,33,6615
Madhya Pradesh,2020,3337,16,297,1244,1383,365,30,6672
Madhya Pradesh,2021,3365,15,301,1291,1379,350,27,6728
Madhya Pradesh,2022,3394,15,304,1339,1374,336,25,6787
Madhya Pradesh,2023,3422,15,307,1386,1369,321,22,6842
Madhya Pradesh,2024,3450,15,311,1434,1364,306,19,6899
Maharashtra,2001,1302,4,152,419,503,135,89,2604
Maharashtra,2002,1352,7,130,319,693,140,63,2704
Maharashtra,2003,1268,4,116,417,541,119,79,2544
Maharashtra,2004,1388,5,133,419,627,123,85,2780
Maharashtra,2005,1545,2,132,421,735,174,85,3094
Maharashtra,2006,1500,4,127,445,707,140,83,3006
Maharashtra,2007,1451,13,125,393,659,168,99,2908
Maharashtra,2008,1558,5,135,441,707,161,118,3125
Maharashtra,2009,1483,8,121,363,713,157,131,2976
Maharashtra,2010,1599,11,134,515,675,168,108,3210
Maharashtra,2011,1617,9,125,456,742,172,123,3244
Maharashtra,2012,1648,10,124,463,757,177,128,3307
Maharashtra,2013,1680,10,123,471,773,181,134,3372
Maharashtra,2014,1711,11,122,478,789,185,139,3435
Maharashtra,2015,1743,12,121,486,804,190,144,3500
Maharashtra,2016,1774,12,120,493,820,194,150,3563
Maharashtra,2017,1805,13,119,501,836,199,155,3628
Maharashtra,2018,1837,13,118,508,851,203,160,3690
Maharashtra,2019,1868,14,117,516,867,207,166,3755
Maharashtra,2020,1900,15,116,523,883,212,171,3820
Maharashtra,2021,1931,15,115,531,898,216,176,3882
Maharashtra,2022,1963,16,114,539,914,221,182,3949
Maharashtra,2023,1994,17,113,546,930,225,187,4012
Maharashtra,2024,2025,17,112,554,945,230,192,4075
Manipur,2001,20,1,1,4,9,2,3,40
Manipur,2002,14,0,0,0,14,0,0,28
Manipur,2003,18,1,0,7,10,0,0,36
Manipur,2004,31,0,0,2,20,5,4,62
Manipur,2005,25,0,1,0,14,7,3,50
Manipur,2006,40,0,4,9,17,6,6,82
Manipur,2007,20,0,2,0,14,2,2,40
Manipur,2008,38,0,8,8,12,1,9,76
Manipur,2009,31,1,5,2,9,9,5,62
Manipur,2010,34,0,2,8,20,3,1,68
Manipur,2011,37,0,5,5,15,5,5,72
Manipur,2012,39,0,5,6,16,6,5,77
Manipur,2013,41,0,6,6,16,6,5,80
Manipur,2014,43,0,7,6,16,6,6,84
Manipur,2015,45,0,7,7,17,7,6,89
Manipur,2016,47,0,8,7,17,7,7,93
Manipur,2017,49,0,8,8,18,8,7,98
Manipur,2018,51,0,9,8,18,8,7,101
Manipur,2019,53,0,9,8,18,8,8,104
Manipur,2020,55,0,10,9,19,9,8,110
Manipur,2021,57,0,11,9,19,9,8,113
Manipur,2022,59,0,11,9,19,10,9,117
Manipur,2023,61,0,12,10,20,10,9,122
Manipur,2024,63,0,12,10,20,11,9,125
Meghalaya,2001,26,0,2,4,14,3,3,52
Meghalaya,2002,38,0,9,22,4,0,3,76
Meghalaya,2003,40,1,5,15,14,1,4,80
Meghalaya,2004,54,0,8,9,34,0,3,108
Meghalaya,2005,63,0,10,32,8,4,9,126
Meghalaya,2006,74,0,11,23,23,3,14,148
Meghalaya,2007,82,0,12,19,36,2,24,175
Meghalaya,2008,88,0,17,14,47,4,6,176
Meghalaya,2009,112,3,23,19,41,7,19,224
Meghalaya,2010,149,0,34,26,41,17,33,300
Meghalaya,2011,137,0,28,24,49,10,27,275
Meghalaya,2012,149,1,31,25,53,11,29,299
Meghalaya,2013,161,1,33,27,57,12,32,323
Meghalaya,2014,173,1,36,28,61,14,35,348
Meghalaya,2015,185,1,39,29,65,15,38,372
Meghalaya,2016,197,1,42,30,69,16,41,396
Meghalaya,2017,209,1,45,31,74,17,43,420
Meghalaya,2018,221,1,47,32,78,18,46,443
Meghalaya,2019,232,1,50,34,82,20,49,468
Meghalaya,2020,244,1,53,35,86,21,52,492
Meghalaya,2021,256,1,56,36,90,22,55,516
Meghalaya,2022,268,2,59,37,95,23,57,541
Meghalaya,2023,280,2,61,38,99,24,60,564
Meghalaya,2024,292,2,64,39,103,25,63,588
Mizoram,2001,52,0,0,30,14,8,0,104
Mizoram,2002,76,9,1,1,52,13,0,152
Mizoram,2003,54,0,3,6,22,22,1,108
Mizoram,2004,20,0,0,0,12,8,0,40
Mizoram,2005,37,0,0,30,7,0,0,74
Mizoram,2006,72,0,19,9,32,5,7,144
Mizoram,2007,83,2,23,18,10,7,23,166
Mizoram,2008,77,0,4,5,49,10,9,154
Mizoram,2009,83,0,3,3,42,30,5,166
Mizoram,2010,92,4,17,15,29,17,10,184
Mizoram,2011,89,0,15,8,34,16,13,175
Mizoram,2012,94,0,17,8,35,17,14,185
Mizoram,2013,98,0,18,7,36,18,16,193
Mizoram,2014,103,0,20,6,38,19,17,203
Mizoram,2015,107,0,21,6,39,20,19,212
Mizoram,2016,112,0,23,5,40,21,20,221
Mizoram,2017,116,0,25,5,42,21,22,231
Mizoram,2018,121,0,26,4,43,22,23,239
Mizoram,2019,125,0,28,4,44,23,25,249
Mizoram,2020,130,0,29,3,46,24,26,258
Mizoram,2021,134,0,31,2,47,25,28,267
Mizoram,2022,139,0,33,2,48,26,29,277
Mizoram,2023,143,0,34,1,50,27,31,286
Mizoram,2024,148,0,36,1,51,27,32,295
Nagaland,2001,17,0,0,8,6,3,0,34
Nagaland,2002,17,0,1,3,11,0,2,34
Nagaland,2003,14,0,0,0,14,0,0,28
Nagaland,2004,18,0,0,0,17,0,1,36
Nagaland,2005,17,0,0,0,12,2,3,34
Nagaland,2006,23,0,1,4,11,1,6,46
Nagaland,2007,13,0,0,3,6,4,0,26
Nagaland,2008,19,0,0,0,19,0,0,38
Nagaland,2009,22,0,0,0,17,5,0,44
Nagaland,2010,16,0,1,2,6,6,1,32
Nagaland,2011,19,0,0,0,13,4,1,37
Nagaland,2012,19,0,0,0,13,4,1,37
Nagaland,2013,19,0,0,0,13,5,1,38
Nagaland,2014,19,0,0,-1,13,5,1,37
Nagaland,2015,20,0,0,-1,13,6,1,39
Nagaland,2016,20,0,0,-1,14,6,0,39
Nagaland,2017,20,0,0,-2,14,7,0,39
Nagaland,2018,20,0,0,-2,14,7,0,39
Nagaland,2019,21,0,0,-3,14,8,0,40
Nagaland,2020,21,0,0,-3,14,8,0,40
Nagaland,2021,21,0,0,-3,15,8,0,41
Nagaland,2022,21,0,0,-4,15,9,0,41
Nagaland,2023,22,0,0,-4,15,9,0,42
Nagaland,2024,22,0,0,-4,15,10,0,43
Odisha,2001,790,0,9,297,402,74,8,1580
Odisha,2002,691,0,9,0,614,56,12,1382
Odisha,2003,725,1,18,32,586,83,5,1450
Odisha,2004,770,0,2,2,616,123,27,1540
Odisha,2005,799,3,0,10,636,132,18,1598
Odisha,2006,985,2,51,27,730,152,23,1970
Odisha,2007,939,0,41,42,659,188,9,1878
Odisha,2008,1113,12,27,24,645,388,17,2226
Odisha,2009,1023,7,24,57,747,182,6,2046
Odisha,2010,1025,5,17,44,787,159,13,2050
Odisha,2011,1121,7,32,-5,806,266,14,2241
Odisha,2012,1164,8,35,-16,835,287,14,2327
Odisha,2013,1207,9,37,-27,865,307,14,2412
Odisha,2014,1250,10,39,-38,895,328,14,2498
Odisha,2015,1293,11,42,-49,925,348,14,2584
Odisha,2016,1336,12,44,-59,954,369,14,2670
Odisha,2017,1378,13,46,-70,984,389,14,2754
Odisha,2018,1421,14,49,-81,1014,410,14,2841
Odisha,2019,1464,15,51,-92,1044,430,14,2926
Odisha,2020,1507,16,54,-103,1074,451,15,3014
Odisha,2021,1550,16,56,-113,1103,471,15,3098
Odisha,2022,1593,17,58,-124,1133,492,15,3184
Odisha,2023,1636,18,61,-135,1163,512,15,3270
Odisha,2024,1678,19,63,-146,1193,533,15,3355
Puducherry,2001,9,0,2,2,1,1,3,18
Puducherry,2002,6,0,0,3,2,0,1,12
Puducherry,2003,2,0,0,0,1,0,1,4
Puducherry,2004,4,0,0,4,0,0,0,8
Puducherry,2005,6,0,0,2,3,0,1,12
Puducherry,2006,9,0,1,5,1,0,2,18
Puducherry,2007,9,0,0,2,6,0,1,18
Puducherry,2008,8,0,1,3,3,1,0,16
Puducherry,2009,1,0,0,1,0,0,0,2
Puducherry,2010,3,0,0,3,0,0,0,6
Puducherry,2011,4,0,0,2,1,0,0,7
Puducherry,2012,4,0,0,2,1,0,0,7
Puducherry,2013,3,0,0,2,1,0,0,6
Puducherry,2014,3,0,0,2,1,0,0,6
Puducherry,2015,3,0,0,2,1,0,-1,5
Puducherry,2016,3,0,0,2,1,0,-1,5
Puducherry,2017,2,0,0,2,1,0,-1,4
Puducherry,2018,2,0,0,3,1,0,-1,5
Puducherry,2019,2,0,0,3,1,0,-1,5
Puducherry,2020,2,0,0,3,1,0,-2,4
Puducherry,2021,1,0,0,3,1,0,-2,3
Puducherry,2022,1,0,0,3,2,0,-2,4
Puducherry,2023,1,0,0,3,2,0,-2,4
Puducherry,2024,1,0,0,3,2,0,-3,3
Punjab,2001,298,1,30,137,98,24,8,596
Punjab,2002,299,1,12,32,213,33,8,598
Punjab,2003,380,1,14,34,262,63,6,760
Punjab,2004,390,0,12,35,262,74,7,780
Punjab,2005,398,0,19,23,239,108,9,796
Punjab,2006,442,0,19,26,319,64,14,884
Punjab,2007,519,3,38,71,302,79,26,1038
Punjab,2008,517,5,36,45,359,47,27,1036
Punjab,2009,511,1,48,131,258,43,34,1026
Punjab,2010,546,1,39,83,346,55,23,1093
Punjab,2011,591,2,44,74,373,67,32,1183
Punjab,2012,620,2,47,76,393,68,35,1241
Punjab,2013,649,2,50,78,412,69,38,1298
Punjab,2014,678,2,53,80,432,71,41,1357
Punjab,2015,708,2,56,83,451,72,44,1416
Punjab,2016,737,3,59,85,471,74,47,1476
Punjab,2017,766,3,63,87,491,75,49,1534
Punjab,2018,796,3,66,89,510,77,52,1593
Punjab,2019,825,3,69,92,530,78,55,1652
Punjab,2020,854,3,72,94,549,80,58,1710
Punjab,2021,883,4,75,96,569,81,61,1769
Punjab,2022,913,4,78,99,589,83,64,1830
Punjab,2023,942,4,81,101,608,84,67,1887
Punjab,2024,971,4,85,103,628,85,70,1946
Rajasthan,2001,1049,7,44,229,606,147,16,2098
Rajasthan,2002,1051,5,8,25,788,220,5,2102
Rajasthan,2003,1050,7,11,31,751,243,7,2100
Rajasthan,2004,1038,7,41,86,645,249,10,2076
Rajasthan,2005,993,16,44,181,515,216,21,1986
Rajasthan,2006,1085,5,80,197,555,214,34,2170
Rajasthan,2007,1238,8,79,286,639,187,41,2478
Rajasthan,2008,1355,10,116,275,706,219,29,2710
Rajasthan,2009,1519,4,55,288,856,289,28,3039
Rajasthan,2010,1571,36,72,277,805,346,37,3144
Rajasthan,2011,1534,19,96,324,755,298,41,3067
Rajasthan,2012,1596,20,104,349,767,310,45,3191
Rajasthan,2013,1658,22,112,374,780,322,48,3316
Rajasthan,2014,1719,23,119,399,792,334,51,3437
Rajasthan,2015,1781,25,127,424,805,346,55,3563
Rajasthan,2016,1843,27,134,448,817,358,58,3685
Rajasthan,2017,1905,28,142,473,830,370,62,3810
Rajasthan,2018,1966,30,150,498,842,381,65,3932
Rajasthan,2019,2028,31,157,523,855,393,69,4056
Rajasthan,2020,2090,33,165,548,867,405,72,4180
Rajasthan,2021,2152,35,172,573,880,417,75,4304
Rajasthan,2022,2214,36,180,598,893,429,79,4429
Rajasthan,2023,2275,38,188,623,905,441,82,4552
Rajasthan,2024,2337,39,195,648,918,453,86,4676
Sikkim,2001,8,0,0,4,2,1,1,16
Sikkim,2002,6,0,2,2,2,0,0,12
Sikkim,2003,10,0,4,1,1,0,4,20
Sikkim,2004,3,0,1,1,0,2,0,7
Sikkim,2005,18,0,5,7,2,2,4,38
Sikkim,2006,20,0,4,5,3,0,8,40
Sikkim,2007,24,0,3,5,5,1,10,48
Sikkim,2008,20,0,3,1,8,0,9,41
Sikkim,2009,18,0,5,5,2,2,4,36
Sikkim,2010,18,0,7,2,1,2,6,36
Sikkim,2011,24,0,6,3,4,1,9,47
Sikkim,2012,25,0,6,3,4,1,9,48
Sikkim,2013,27,0,7,3,4,1,10,52
Sikkim,2014,29,0,7,3,4,1,11,55
Sikkim,2015,31,0,8,4,5,2,12,62
Sikkim,2016,32,0,8,4,5,2,13,64
Sikkim,2017,34,0,9,4,5,2,13,67
Sikkim,2018,36,0,9,4,5,2,14,70
Sikkim,2019,38,0,10,4,6,2,15,75
Sikkim,2020,39,0,10,4,6,2,16,77
Sikkim,2021,41,0,11,4,6,2,17,81
Sikkim,2022,43,0,11,4,6,2,17,83
Sikkim,2023,45,0,12,4,7,2,18,88
Sikkim,2024,46,0,12,4,7,3,19,91
Tamil Nadu,2001,423,2,15,174,192,34,6,846
Tamil Nadu,2002,534,1,8,6,465,39,15,1068
Tamil Nadu,2003,557,1,14,21,360,149,12,1114
Tamil Nadu,2004,618,3,50,85,417,30,34,1237
Tamil Nadu,2005,571,0,28,58,396,60,29,1142
Tamil Nadu,2006,457,2,34,68,275,55,23,914
Tamil Nadu,2007,523,1,41,89,346,35,20,1055
Tamil Nadu,2008,573,0,29,131,340,46,27,1146
Tamil Nadu,2009,596,2,34,120,390,22,28,1192
Tamil Nadu,2010,686,0,50,139,411,66,21,1373
Tamil Nadu,2011,636,0,48,124,392,42,29,1271
Tamil Nadu,2012,651,0,52,130,399,40,31,1303
Tamil Nadu,2013,666,0,55,137,405,38,33,1334
Tamil Nadu,2014,681,0,58,143,411,36,34,1363
Tamil Nadu,2015,696,0,62,149,417,34,36,1394
Tamil Nadu,2016,711,0,65,156,423,32,37,1424
Tamil Nadu,2017,726,0,68,162,429,30,39,1454
Tamil Nadu,2018,741,0,72,169,435,28,40,1485
Tamil Nadu,2019,756,0,75,175,442,26,42,1516
Tamil Nadu,2020,771,0,78,181,448,24,43,1545
Tamil Nadu,2021,786,0,82,188,454,22,45,1577
Tamil Nadu,2022,802,0,85,194,460,20,46,1607
Tamil Nadu,2023,817,0,88,200,466,17,48,1636
Tamil Nadu,2024,832,-1,92,207,472,15,49,1666
Tripura,2001,102,0,0,50,47,5,0,204
Tripura,2002,108,0,0,0,98,10,0,216
Tripura,2003,114,0,0,0,102,12,0,228
Tripura,2004,160,0,7,14,109,23,7,320
Tripura,2005,162,0,13,4,129,13,3,324
Tripura,2006,189,1,4,34,135,17,0,380
Tripura,2007,157,0,14,16,113,11,3,314
Tripura,2008,204,0,23,65,96,4,16,408
Tripura,2009,190,0,22,51,79,28,10,380
Tripura,2010,238,0,27,61,93,38,19,476
Tripura,2011,237,0,28,56,109,27,16,473
Tripura,2012,251,0,31,61,110,29,17,499
Tripura,2013,265,0,34,66,112,32,19,528
Tripura,2014,279,0,37,71,113,34,21,555
Tripura,2015,292,0,41,76,115,36,23,583
Tripura,2016,306,0,44,81,117,38,25,611
Tripura,2017,320,0,47,86,118,40,27,638
Tripura,2018,334,0,50,91,120,42,28,665
Tripura,2019,347,0,53,96,122,44,30,692
Tripura,2020,361,0,57,101,123,46,32,720
Tripura,2021,375,0,60,106,125,49,34,749
Tripura,2022,389,0,63,111,127,51,36,777
Tripura,2023,402,0,66,116,128,53,38,803
Tripura,2024,416,0,69,121,130,55,40,831
Uttar Pradesh,2001,1958,0,122,406,1082,314,34,3916
Uttar Pradesh,2002,1415,0,111,271,775,220,38,2830
Uttar Pradesh,2003,911,2,75,207,477,117,33,1822
Uttar Pradesh,2004,1397,2,99,242,838,163,53,2794
Uttar Pradesh,2005,1217,5,103,247,656,162,44,2434
Uttar Pradesh,2006,1314,3,56,273,780,184,18,2628
Uttar Pradesh,2007,1648,0,109,349,910,267,13,3296
Uttar Pradesh,2008,1871,0,171,685,785,186,44,3742
Uttar Pradesh,2009,1759,0,416,166,911,223,43,3518
Uttar Pradesh,2010,1563,0,162,246,862,250,43,3126
Uttar Pradesh,2011,1655,0,241,327,836,212,37,3308
Uttar Pradesh,2012,1682,0,258,331,841,213,37,3362
Uttar Pradesh,2013,1709,0,276,334,846,214,37,3416
Uttar Pradesh,2014,1737,0,294,338,851,214,37,3471
Uttar Pradesh,2015,1764,0,312,341,856,215,37,3525
Uttar Pradesh,2016,1791,0,330,344,861,216,37,3579
Uttar Pradesh,2017,1819,0,348,348,866,217,38,3636
Uttar Pradesh,2018,1846,0,366,351,872,217,38,3690
Uttar Pradesh,2019,1873,0,384,355,877,218,38,3745
Uttar Pradesh,2020,1901,0,402,358,882,219,38,3800
Uttar Pradesh,2021,1928,0,420,361,887,220,38,3854
Uttar Pradesh,2022,1955,0,438,365,892,221,38,3909
Uttar Pradesh,2023,1982,0,456,368,897,221,38,3962
Uttar Pradesh,2024,2010,0,474,372,903,222,39,4020
Uttarakhand,2001,74,0,7,16,38,7,6,148
Uttarakhand,2002,89,0,4,2,66,15,2,178
Uttarakhand,2003,107,0,4,6,83,13,1,214
Uttarakhand,2004,115,0,6,9,72,26,2,230
Uttarakhand,2005,133,0,3,12,95,20,3,266
Uttarakhand,2006,147,0,7,15,106,18,1,294
Uttarakhand,2007,117,0,9,7,74,26,1,234
Uttarakhand,2008,87,0,4,5,64,14,0,174
Uttarakhand,2009,111,0,3,3,89,15,1,222
Uttarakhand,2010,121,0,3,5,92,19,2,242
Uttarakhand,2011,126,0,4,4,96,20,0,250
Uttarakhand,2012,129,0,3,4,100,21,0,257
Uttarakhand,2013,132,0,3,3,103,22,0,263
Uttarakhand,2014,135,0,3,2,107,23,0,270
Uttarakhand,2015,138,0,3,2,110,23,-1,275
Uttarakhand,2016,141,0,3,1,114,24,-1,282
Uttarakhand,2017,144,0,2,1,117,25,-1,288
Uttarakhand,2018,147,0,2,0,121,25,-2,293
Uttarakhand,2019,150,0,2,0,124,26,-2,300
Uttarakhand,2020,153,0,2,0,127,27,-2,307
Uttarakhand,2021,156,0,2,-1,131,27,-3,312
Uttarakhand,2022,159,0,2,-2,134,28,-3,318
Uttarakhand,2023,162,0,1,-2,138,29,-3,325
Uttarakhand,2024,165,0,1,-3,141,29,-4,329
West Bengal,2001,709,0,3,5,594,103,4,1418
West Bengal,2002,759,0,3,8,552,191,5,1518
West Bengal,2003,1002,2,7,4,826,158,5,2004
West Bengal,2004,1475,1,3,14,965,490,2,2950
West Bengal,2005,1686,1,0,3,1451,228,3,3372
West Bengal,2006,1731,0,5,13,1477,234,2,3462
West Bengal,2007,2106,5,42,36,1478,531,14,4212
West Bengal,2008,2263,1,53,54,1629,504,22,4526
West Bengal,2009,2336,0,18,85,1835,392,6,4672
West Bengal,2010,2311,0,22,51,1779,459,0,4622
West Bengal,2011,2761,1,36,69,2099,544,9,5519
West Bengal,2012,2965,1,40,77,2252,583,9,5927
West Bengal,2013,3169,1,44,85,2405,623,10,6337
West Bengal,2014,3373,1,47,93,2558,662,10,6744
West Bengal,2015,3578,1,51,100,2711,701,11,7153
West Bengal,2016,3782,1,55,108,2863,740,12,7561
West Bengal,2017,3986,1,59,116,3016,779,12,7969
West Bengal,2018,4190,1,63,124,3169,819,13,8379
West Bengal,2019,4395,1,66,131,3322,858,13,8786
West Bengal,2020,4599,1,70,139,3475,897,14,9195
West Bengal,2021,4803,1,74,147,3628,936,14,9603
West Bengal,2022,5007,1,78,155,3781,976,15,10013
West Bengal,2023,5212,1,82,162,3934,1015,15,10421
West Bengal,2024,5416,1,86,170,4086,1054,16,10829
